0766666666
7766666666
6666666666
6666666666
8999999876
3535111197
3541111129
3461111130
3346111130
7334655562
